10.ox
..o.......
..oo......
.....o.ooo
..........
o...o..o.o
....o.....
.ooo.....o
..........
....o...o.
......o..o
