10.ox
oo......o.
..oo......
oo........
....o.....
.o........
....o...o.
......o...
........o.
o...o.....
....o.o...
