10.ox
.....o....
..o.....o.
..ooo.....
.oo...o.o.
o........o
.......o..
.......o..
..o.......
..........
