20.ox
............oo.......o..............o......oo.o...
...o............o.........................o.oo.o..
o...............ooo............o.........o.oo.....
......oo........................o....o..o.........
.............o...oo.......o.o....o....o...........
..o......................oo.............o..o....o.
...oo.................o............o..............
.......oo.......oo...........o.........o......o.oo
...ooo.o..........o...o...o........oo...........o.
........................o......o.......o......o...
..........o.o.......o...o........................o
.........o.o..o.o.o.............o.....o.........o.
.................o.........................o...o.o
..oo................o.............................
..o......................o....o................o..
...................o...o........o.................
.......o....o..o....oo...o.......o......o.........
...........o.......o..o....o...o...o............o.
.o.........o....o..............o.....o.....o......
.....o...o...........o.o......o..o................
