20.ox
.o.........o......................................
....................o.....o.......................
..........o...o......................o............
.......o.......o......................o...........
.....o...o......o......................o..........
....oo................................o...o.......
...............oooo......o..o...........o..o......
................................o.................
........o........o..............................o.
...........o..........o...........................
.............o.....o.....o................o......o
.............o............o.......................
o...........o......................o.....o........
..o................o..............................
...............................................o..
............o.....................................
...................................o......o......o
.o..........................o................o....
..........o.................o.....................
..............................oo..o...............
